date,fiscalDateEnding,reportedCurrency,grossProfit,totalRevenue,costOfRevenue,costofGoodsAndServicesSold,operatingIncome,sellingGeneralAndAdministrative,researchAndDevelopment,operatingExpenses,investmentIncomeNet,netInterestIncome,interestIncome,interestExpense,nonInterestIncome,otherNonOperatingIncome,depreciation,depreciationAndAmortization,incomeBeforeTax,incomeTaxExpense,interestAndDebtExpense,netIncomeFromContinuingOperations,comprehensiveIncomeNetOfTax,ebit,ebitda,netIncome
1970-01-01 00:00:00.000000000,2025-03-31,USD,3153000000,19335000000,16182000000,16182000000,399000000,1251000000,1409000000,2754000000,None,309000000,400000000,91000000,None,None,None,1447000000,589000000,169000000,None,420000000,None,680000000,2127000000,409000000
1970-01-01 00:00:00.000000001,2024-12-31,USD,4179000000,25707000000,21528000000,21528000000,1583000000,1313000000,1276000000,2596000000,None,346000000,442000000,96000000,None,None,None,1496000000,2766000000,434000000,None,2332000000,None,2862000000,4358000000,2356000000
1970-01-01 00:00:00.000000002,2024-09-30,USD,4997000000,25182000000,20185000000,20185000000,2717000000,1186000000,1039000000,2280000000,None,337000000,429000000,92000000,None,None,None,1348000000,2784000000,601000000,None,2183000000,None,2876000000,4224000000,2167000000
1970-01-01 00:00:00.000000003,2024-06-30,USD,4578000000,25500000000,20922000000,20922000000,1605000000,1277000000,1074000000,2973000000,None,262000000,348000000,86000000,None,None,None,1278000000,1887000000,393000000,None,1494000000,None,1973000000,3251000000,1478000000
1970-01-01 00:00:00.000000004,2024-03-31,USD,3696000000,21301000000,17605000000,17605000000,1171000000,1374000000,1151000000,2525000000,None,274000000,350000000,76000000,None,None,None,1246000000,1553000000,409000000,None,1144000000,None,1629000000,2875000000,1129000000
1970-01-01 00:00:00.000000005,2023-12-31,USD,4438000000,25167000000,20729000000,20729000000,2064000000,1280000000,1094000000,2374000000,None,272000000,333000000,61000000,None,None,None,1232000000,2191000000,-5752000000,None,7943000000,None,2252000000,3484000000,7930000000
1970-01-01 00:00:00.000000006,2023-09-30,USD,4178000000,23350000000,19172000000,19172000000,1764000000,1253000000,1161000000,2414000000,None,244000000,244000000,38000000,None,None,None,1235000000,2045000000,167000000,None,1878000000,None,2083000000,3318000000,1853000000
1970-01-01 00:00:00.000000007,2023-06-30,USD,4533000000,24927000000,20394000000,20394000000,2399000000,1191000000,943000000,2134000000,None,210000000,238000000,28000000,None,566000000,None,1154000000,2937000000,323000000,None,2614000000,None,2399000000,3553000000,2703000000
1970-01-01 00:00:00.000000008,2023-03-31,USD,4511000000,23329000000,18818000000,18818000000,2664000000,1076000000,771000000,1847000000,None,184000000,184000000,29000000,None,165000000,None,1046000000,2800000000,261000000,None,2539000000,None,2664000000,3710000000,2513000000
1970-01-01 00:00:00.000000009,2022-12-31,USD,5777000000,24318000000,18541000000,18541000000,3901000000,4311000,810000000,1842000000,None,124000000,157000000,33000000,None,None,None,989000000,3983000000,276000000,None,3707000000,None,3901000000,4890000000,3687000000
1970-01-01 00:00:00.000000010,2022-09-30,USD,5382000000,21454000000,16072000000,16072000000,3688000000,961000000,733000000,1694000000,None,33000000,33000000,53000000,None,1000000,None,956000000,3636000000,305000000,None,3331000000,None,3688000000,4644000000,3292000000
1970-01-01 00:00:00.000000011,2022-06-30,USD,4234000000,16934000000,12700000000,12700000000,2464000000,961000000,667000000,1628000000,None,-18000000,26000000,44000000,None,54000000,None,922000000,2474000000,205000000,None,2269000000,None,2464000000,3386000000,2259000000
1970-01-01 00:00:00.000000012,2022-03-31,USD,5460000000,18756000000,13296000000,13296000000,3603000000,992000000,865000000,1857000000,None,-33000000,28000000,61000000,None,84000000,None,880000000,3626000000,346000000,None,3280000000,None,3603000000,4483000000,3280000000
1970-01-01 00:00:00.000000013,2021-12-31,USD,4847000000,17719000000,12872000000,12872000000,2567000000,1494000000,740000000,2234000000,None,-46000000,25000000,71000000,None,93000000,None,848000000,2635000000,292000000,None,2343000000,None,2706000000,3554000000,2343000000
1970-01-01 00:00:00.000000014,2021-09-30,USD,3660000000,13757000000,10097000000,10097000000,2004000000,994000000,611000000,1605000000,None,-116000000,10000000,126000000,None,4000000,None,761000000,1882000000,223000000,None,1659000000,None,2004000000,2765000000,1618000000
1970-01-01 00:00:00.000000015,2021-06-30,USD,2884000000,11958000000,9074000000,9074000000,1312000000,973000000,576000000,1549000000,None,-64000000,11000000,75000000,None,56000000,None,681000000,1293000000,115000000,None,1178000000,None,1312000000,1993000000,1142000000
1970-01-01 00:00:00.000000016,2021-03-31,USD,2215000000,10389000000,8174000000,8174000000,594000000,1056000000,666000000,1722000000,None,-89000000,10000000,99000000,None,38000000,None,621000000,533000000,69000000,None,464000000,None,594000000,1215000000,438000000
1970-01-01 00:00:00.000000017,2020-12-31,USD,2066000000,10744000000,8678000000,8678000000,575000000,969000000,522000000,1491000000,None,-240000000,6000000,246000000,None,50000000,None,618000000,379000000,83000000,None,296000000,None,575000000,1193000000,239000000
1970-01-01 00:00:00.000000018,2020-09-30,USD,2063000000,8771000000,6708000000,6708000000,809000000,888000000,366000000,1254000000,None,-157000000,6000000,163000000,None,-91000000,None,584000000,555000000,186000000,None,369000000,None,809000000,1393000000,331000000
1970-01-01 00:00:00.000000019,2020-06-30,USD,1267000000,6036000000,4769000000,4769000000,327000000,661000000,279000000,940000000,None,-162000000,8000000,170000000,None,-7000000,None,567000000,150000000,21000000,None,129000000,None,327000000,894000000,104000000
1970-01-01 00:00:00.000000020,2020-03-31,USD,1234000000,5985000000,4751000000,4751000000,239000000,627000000,324000000,951000000,None,-159000000,10000000,169000000,None,-44000000,None,553000000,70000000,2000000,None,68000000,None,239000000,792000000,68000000
1970-01-01 00:00:00.000000021,2019-12-31,USD,1391000000,7384000000,5993000000,5993000000,359000000,699000000,345000000,1044000000,None,-160000000,10000000,170000000,None,None,None,577000000,174000000,42000000,None,132000000,None,359000000,936000000,105000000
1970-01-01 00:00:00.000000022,2019-09-30,USD,1191000000,6303000000,5112000000,5112000000,361000000,596000000,334000000,930000000,None,-170000000,15000000,185000000,None,100000000,None,530851000,176000000,26000000,None,150000000,None,361000000,891851000,143000000
1970-01-01 00:00:00.000000023,2019-06-30,USD,921046000,6349676000,5428630000,5428630000,-80507000,647261000,323898000,971159000,None,-161617000,10362000,171979000,None,-30394000,None,578572000,-369831000,19431000,None,-389262000,None,-80507000,498065000,-389262000
1970-01-01 00:00:00.000000024,2019-03-31,USD,565743000,4541464000,3975721000,3975721000,-443848000,703929000,340174000,1044103000,None,-148691000,8762000,157453000,None,34512000,None,467577000,-644772000,22873000,None,-667645000,None,-443848000,23729000,-667645000
1970-01-01 00:00:00.000000025,2018-12-31,USD,1442900000,7225873000,5782973000,5782973000,251776000,667452000,356297000,1023749000,None,None,None,174723000,None,-6857000,None,496737000,231956000,21878000,None,210078000,None,413536000,910273000,210078000
1970-01-01 00:00:00.000000026,2018-09-30,USD,1523665000,6824413000,5300748000,5300748000,416757000,729876000,350848000,1080724000,None,None,None,175220000,None,29783000,None,502825000,271320000,16647000,None,254673000,None,416757000,919582000,311516000
1970-01-01 00:00:00.000000027,2018-06-30,USD,618930000,4002231000,3383301000,3383301000,-461983000,750759000,386129000,1136888000,None,None,None,163582000,None,55975000,None,485255000,-728999000,13707000,None,-742706000,None,-461983000,23272000,-742706000
1970-01-01 00:00:00.000000028,2018-03-31,USD,456526000,3408751000,2952225000,2952225000,-596974000,686404000,367096000,1053500000,None,None,None,149546000,None,-32502000,None,416233000,-779022000,5605000,None,-784627000,None,-596974000,-180741000,-709551000
1970-01-01 00:00:00.000000029,2017-12-31,USD,438786000,3288249000,2849463000,2849463000,-598141000,682290000,354637000,1036927000,None,None,None,146363000,None,-35397000,None,469606000,-779901000,-9094000,None,-770807000,None,-598141000,-128535000,-770807000
1970-01-01 00:00:00.000000030,2017-09-30,USD,449140000,2984675000,2535535000,2535535000,-535480000,652998000,331622000,984620000,None,None,None,117109000,None,-18859000,None,400624000,-671448000,-285000,None,-671163000,None,-535480000,-134856000,-619376000
1970-01-01 00:00:00.000000031,2017-06-30,USD,666615000,2789557000,2122942000,2122942000,-277339000,537757000,369774000,907531000,None,None,None,108441000,None,-36423000,None,389171000,-385780000,15647000,None,-401427000,None,-277339000,111832000,-336397000
1970-01-01 00:00:00.000000032,2017-03-31,USD,667946000,2696270000,2028324000,2028324000,-272557000,603455000,322040000,925495000,None,None,None,99346000,None,-15008000,None,376602000,-371903000,25278000,None,-397181000,None,-272557000,104045000,-330277000
1970-01-01 00:00:00.000000033,2016-12-31,USD,435278000,2284631000,1849353000,1849353000,-143295000,456016000,245960000,701976000,None,None,None,65104000,None,123403000,None,326939000,-208399000,11070000,None,-219469000,None,-143295000,183644000,-219469000
1970-01-01 00:00:00.000000034,2016-09-30,USD,636735000,2298436000,1661701000,1661701000,85622000,336811000,214302000,551113000,None,None,None,46713000,None,-8898000,None,280468000,30011000,8133000,None,21878000,None,85622000,366090000,21878000
1970-01-01 00:00:00.000000035,2016-06-30,USD,274776000,1270017000,995241000,995241000,-238040000,321152000,191664000,512816000,None,None,None,46368000,None,-5131000,None,183232000,-289539000,3649000,None,-293188000,None,-238040000,-54808000,-293188000
1970-01-01 00:00:00.000000036,2016-03-31,USD,252468000,1147048000,894580000,894580000,-248224000,318210000,182482000,500692000,None,None,None,40625000,None,10428000,None,156460000,-278421000,3846000,None,-282267000,None,-248224000,-91764000,-282267000
1970-01-01 00:00:00.000000037,2015-12-31,USD,218564000,1214380000,995816000,995816000,-260333000,288654000,190243000,478897000,None,None,None,38617000,None,-16399000,None,143723000,-315349000,5048000,None,-320397000,None,-260333000,-116610000,-320397000
1970-01-01 00:00:00.000000038,2015-09-30,USD,231496000,936789000,705293000,705293000,-183662000,236367000,178791000,415158000,None,None,None,29308000,None,-15104000,None,110366000,-228074000,1784000,None,-229858000,None,-183662000,-73296000,-229858000
1970-01-01 00:00:00.000000039,2015-06-30,USD,213370000,954976000,741606000,741606000,-170188000,201846000,181712000,383558000,None,None,None,24352000,None,13480000,None,91389000,-181060000,3167000,None,-184227000,None,-170188000,-78799000,-184227000
1970-01-01 00:00:00.000000040,2015-03-31,USD,260073000,939880000,679807000,679807000,-102446000,195365000,167154000,362519000,None,None,None,26574000,None,-22121000,None,77112000,-151141000,3040000,None,-154181000,None,-102446000,-25334000,-154181000
1970-01-01 00:00:00.000000041,2014-12-31,USD,261697000,956661000,694964000,694964000,-74838000,196970000,139565000,336535000,None,None,None,28703000,None,-371000,None,67976000,-103910000,3719000,None,-107632000,None,-74838000,-6862000,-107629000
1970-01-01 00:00:00.000000042,2014-09-30,USD,251851000,851804000,599953000,599953000,-41919000,155107000,135873000,290980000,None,None,None,29062000,None,-2790000,None,64972000,-70981000,3727000,None,-74708000,None,-41919000,23053000,-74708000
1970-01-01 00:00:00.000000043,2014-06-30,USD,212995000,769349000,556354000,556354000,-29512000,134031000,107717000,241748000,None,None,None,31238000,None,-759000,None,54715000,-60750000,1150000,None,-61900000,None,-29512000,25203000,-61900000
1970-01-01 00:00:00.000000044,2014-03-31,USD,155128000,620542000,465414000,465414000,-37108000,117551000,81544000,199095000,None,None,None,11883000,None,6859000,None,44268000,-48991000,809000,None,-49800000,None,-37108000,7160000,-49800000
1970-01-01 00:00:00.000000045,2013-12-31,USD,156589000,615219000,458630000,458630000,-8677000,101489000,68453000,169942000,None,None,None,6229000,None,4655000,None,37585000,-14906000,1358000,None,-16264000,None,-8677000,28908000,-16264000
1970-01-01 00:00:00.000000046,2013-09-30,USD,102868000,431346000,328478000,328478000,-30554000,77071000,56351000,133422000,None,None,None,6492000,None,-672000,None,28450000,-37718000,778000,None,-38496000,None,-30554000,-2104000,-38496000
1970-01-01 00:00:00.000000047,2013-06-30,USD,100483000,405139000,304656000,304656000,-10085000,59963000,52312000,112275000,None,None,None,20116000,None,1707000,None,22198000,-30201000,301000,None,-30502000,None,-10085000,12113000,-30502000
1970-01-01 00:00:00.000000048,2013-03-31,USD,96320000,561792000,465472000,465472000,11517000,47045000,54859000,101904000,None,None,None,118000,None,17101000,None,17850000,11399000,151000,None,11248000,None,11517000,29367000,11248000
1970-01-01 00:00:00.000000049,2012-12-31,USD,23857000,306332000,282475000,282475000,-90883000,45908000,68832000,114740000,None,None,None,26000,None,831000,None,12792000,-90079000,-148000,None,-89933000,None,-90883000,-78091000,-89931000
1970-01-01 00:00:00.000000050,2012-09-30,USD,-8761000,50104000,58865000,58865000,-108460000,37798000,61901000,99699000,None,None,None,78000,None,-2150000,None,7522000,-110688000,116000,None,-110804000,None,-108460000,-100938000,-110804000
1970-01-01 00:00:00.000000051,2012-06-30,USD,4762000,26653000,21891000,21891000,-106175000,36083000,74854000,110937000,None,None,None,84000,None,765000,None,4348000,-105494000,109000,None,-105603000,None,-106175000,-101827000,-105603000
1970-01-01 00:00:00.000000052,2012-03-31,USD,10210000,30167000,19957000,19957000,-88763000,30582000,68391000,98973000,None,None,None,65000,None,-986000,None,4163000,-89814000,59000,None,-89873000,None,-88763000,-84600000,-89873000
1970-01-01 00:00:00.000000053,2011-12-31,USD,7835000,39375000,31540000,31540000,-80927000,27557000,61205000,88762000,None,None,None,43000,None,None,None,4804000,-81377000,112000,None,0,None,-80927000,-76123000,-81489000
1970-01-01 00:00:00.000000054,2011-09-30,USD,17224000,57666000,40442000,40442000,-64477000,27618000,54083000,81701000,None,None,None,80000,None,-514000,None,4280000,-64991000,87000,None,-65078000,None,-64477000,-60197000,-65078000
1970-01-01 00:00:00.000000055,2011-06-30,USD,18508000,58171000,39663000,39663000,-58739000,24716000,52531000,77247000,None,None,None,46000,None,-25000,None,4318000,-58764000,139000,None,-58903000,None,-58739000,-54421000,-58903000
1970-01-01 00:00:00.000000056,2011-03-31,USD,18028000,49030000,31002000,31002000,-47346000,24212000,41162000,65374000,None,None,None,40000,None,None,None,3517000,-48791000,150000,None,0,None,-47346000,-43829000,-48941000
1970-01-01 00:00:00.000000057,2010-12-31,USD,11321000,36286000,24965000,24965000,-51645000,25349000,37617000,62966000,None,None,None,63000,None,None,None,2890000,-51395000,-37000,None,0,None,-51645000,-48755000,-51358000
1970-01-01 00:00:00.000000058,2010-09-30,USD,9296000,31241000,21945000,21945000,-37834000,20432000,26698000,47130000,None,None,None,298000,None,None,None,3109000,-34852000,83000,None,0,None,-37834000,-34725000,-34935000
1970-01-01 00:00:00.000000059,2010-06-30,USD,6261000,28405000,22144000,22144000,-31362000,37623000,15416000,37623000,None,None,None,464000,None,None,None,2483000,-38508000,9000,None,0,None,-31362000,-28879000,-38517000
1970-01-01 00:00:00.000000060,2010-03-31,USD,3852000,20812000,16960000,16960000,-25998000,29850000,13265000,29850000,None,None,None,230000,None,None,None,2141000,-29401000,118000,None,0,None,-25998000,-23857000,-29519000
1970-01-01 00:00:00.000000061,2009-12-31,USD,1781000,18585000,16804000,16804000,-22925000,24706000,8143000,24706000,None,None,None,25000,None,None,None,1935000,-24013000,229000,None,0,None,-22925000,-20990000,-24242000
1970-01-01 00:00:00.000000062,2009-09-30,USD,7699000,45527000,37828000,37828000,-4291000,11990000,1257000,11990000,None,None,None,18000,None,None,None,1948000,-4834000,-219000,None,0,None,-4291000,-2343000,-4615000
1970-01-01 00:00:00.000000063,2009-06-30,USD,2101000,26945000,24844000,24844000,-8087000,10188000,1941000,10188000,None,None,None,1086000,None,None,None,1685000,-10859000,8000,None,0,None,-8087000,-6402000,-10867000
1970-01-01 00:00:00.000000064,2009-03-31,USD,-2046000,20886000,22932000,22932000,-16594000,14548000,7941000,14548000,None,None,None,1402000,None,None,None,1372000,-16008000,8000,None,0,None,-16594000,-15222000,-16016000
1970-01-01 00:00:00.000000065,2008-12-31,USD,-1702000,14162000,15864000,15864000,-23224000,77363000,11826000,21522000,None,None,None,1099000,None,None,None,1294000,-25474000,24000,None,0,None,-23224000,-21930000,-25498000
1970-01-01 00:00:00.000000066,2008-09-30,USD,-1702000,14162000,15864000,15864000,-23224000,None,11826000,21522000,None,None,None,1099000,None,None,None,1294000,-25474000,24000,None,None,None,-23224000,-21930000,-25498000
1970-01-01 00:00:00.000000067,2008-03-31,USD,-285250,3685500,3970750,3970750,-19626000,5912250,13428500,-19340750,None,None,None,936750,None,None,None,108500,-20671250,24250,None,None,None,-19626000,-19517500,-20695500
1970-01-01 00:00:00.000000068,2007-12-31,USD,-285250,3685500,3970750,3970750,-19626000,5912250,13428500,-19340750,None,None,None,936750,None,None,None,108500,-20671250,24250,None,None,None,-19626000,-19517500,-20695500
1970-01-01 00:00:00.000000069,2007-03-31,USD,16000,18250,2250,2250,-19983250,4311000,15688250,-19999250,None,None,None,471500,None,None,None,471500,-19511750,27500,None,None,None,-19983250,-19511750,-19539250
